0 0 0 0 0 0 0 0 0 0 10 10 10 0 1 1 0 0 0 0 0 0 0 10 10 10 0 1 1 0 0 0 0 0 0 0 10 10 10 0 1 1 1 1 0 0 0 0 0 10 10 10 0 1 1 1 1 0 0 0 0 0 10 10 10 0 1 1 0 0 0 0 0 0 0 10 10 10 0 0 0 0 0 0 0 0 0 0 10 10 10 0 0 0 0 0 0 0 0 0 0 10 10 10 0 0 0 0 0 0 0 0 0 0 10 10 10 0 0 0 0 0 0 0 0 0 0 10 10 10 2 4 2 1 2 3 4 2 1 1 3 
0 0 0 0 0 0 0 0 0 0 10 10 10 0 0 0 1 1 0 0 0 0 0 10 10 10 0 0 1 1 1 0 0 0 0 0 10 10 10 0 1 1 1 1 1 0 0 0 0 10 10 10 0 1 1 1 1 1 0 0 0 0 10 10 10 0 0 0 1 1 1 0 0 0 0 10 10 10 0 0 0 0 0 0 0 0 0 0 10 10 10 0 0 0 0 0 0 0 0 0 0 10 10 10 0 0 0 0 0 0 0 0 0 0 10 10 10 0 0 0 0 0 0 0 0 0 0 10 10 10 2 2 3 3 2 2 3 3 3 4 2 2 4 4 4 
0 0 0 0 0 0 0 0 0 0 10 10 10 0 0 0 1 1 1 0 0 0 0 10 10 10 0 0 0 1 1 1 1 0 0 0 10 10 10 0 0 0 0 1 1 1 0 0 0 10 10 10 0 0 0 0 0 1 1 0 0 0 10 10 10 0 0 0 0 0 0 1 0 0 0 10 10 10 0 0 0 0 0 0 0 0 0 0 10 10 10 0 0 0 0 0 0 0 0 0 0 10 10 10 0 0 0 0 0 0 0 0 0 0 10 10 10 0 0 0 0 0 0 0 0 0 0 10 10 10 4 1 2 4 2 5 2 3 1 6 5 
0 0 0 0 0 0 0 0 0 0 10 10 10 0 0 0 0 0 1 1 1 0 0 10 10 10 0 0 0 0 0 1 1 1 0 0 10 10 10 0 0 0 1 1 1 0 0 0 0 10 10 10 0 0 0 1 1 1 1 1 0 0 10 10 10 0 0 0 1 1 1 1 1 0 0 10 10 10 0 0 0 0 0 0 0 0 0 0 10 10 10 0 0 0 0 0 0 0 0 0 0 10 10 10 0 0 0 0 0 0 0 0 0 0 10 10 10 0 0 0 0 0 0 0 0 0 0 10 10 10 7 1 2 5 2 6 2 4 5 6 5 
0 0 0 0 0 0 0 0 0 0 10 10 10 0 1 1 1 1 1 1 1 1 0 10 10 10 0 1 1 1 1 1 1 1 1 0 10 10 10 0 1 1 1 1 1 1 1 1 0 10 10 10 0 0 1 1 1 1 1 1 0 0 10 10 10 0 0 0 1 1 1 1 1 0 0 10 10 10 0 0 0 1 1 1 1 1 0 0 10 10 10 0 0 0 1 1 1 1 1 1 0 10 10 10 0 0 0 0 0 0 1 1 1 0 10 10 10 0 0 0 0 0 0 0 0 0 0 10 10 10 2 3 1 5 5 8 8 
0 0 0 0 0 0 0 0 0 0 10 10 10 0 0 0 0 0 0 0 0 0 0 10 10 10 0 1 1 1 0 1 1 1 0 0 10 10 10 0 1 1 1 0 1 1 1 0 0 10 10 10 0 1 1 1 1 1 1 1 0 0 10 10 10 0 0 0 1 1 1 0 0 0 0 10 10 10 0 1 1 1 1 1 1 1 0 0 10 10 10 0 1 1 1 0 1 1 1 0 0 10 10 10 0 1 1 1 0 1 1 1 0 0 10 10 10 0 0 0 0 0 0 0 0 0 0 10 10 10 4 5 4 2 3 6 3 2 7 6 7 3 4 5 4 3 6 5 6 
0 0 0 0 0 0 0 0 0 0 10 10 10 0 0 0 1 1 1 1 1 1 0 10 10 10 0 0 0 1 0 0 1 1 1 0 10 10 10 0 1 1 1 1 1 1 0 1 0 10 10 10 0 1 0 1 0 1 1 1 1 0 10 10 10 0 1 1 1 1 1 0 1 1 0 10 10 10 0 1 0 1 1 1 1 1 1 0 10 10 10 0 1 1 1 0 1 1 0 1 0 10 10 10 0 1 0 1 1 1 1 0 1 0 10 10 10 0 0 0 0 0 0 0 0 0 0 10 10 10 4 5 2 6 4 2 5 8 7 8 8 
0 0 0 0 0 0 0 0 0 0 10 10 10 0 0 0 1 1 1 1 1 1 0 10 10 10 0 1 0 1 1 1 1 1 1 0 10 10 10 0 1 0 1 1 1 1 1 1 0 10 10 10 0 1 0 0 0 1 1 1 1 0 10 10 10 0 1 1 1 1 1 1 1 1 0 10 10 10 0 1 0 0 0 0 0 1 1 0 10 10 10 0 1 1 1 1 1 0 1 1 0 10 10 10 0 1 1 1 1 1 1 1 1 0 10 10 10 0 0 0 0 0 0 0 0 0 0 10 10 10 3 1 2 4 2 6 2 1 2 1 3 
0 0 0 0 0 0 0 0 0 0 10 10 10 0 1 1 1 1 1 1 1 1 0 10 10 10 0 1 1 1 0 1 1 1 1 0 10 10 10 0 1 1 0 0 1 1 1 1 0 10 10 10 0 1 0 0 0 0 1 1 1 0 10 10 10 0 1 0 0 0 0 0 1 1 0 10 10 10 0 1 1 1 1 1 1 1 1 0 10 10 10 0 1 1 1 1 1 0 1 1 0 10 10 10 0 1 1 1 1 1 1 1 1 0 10 10 10 0 0 0 0 0 0 0 0 0 0 10 10 10 3 1 2 6 3 7 4 1 7 1 8 
0 0 0 0 0 0 0 0 0 0 10 10 10 0 1 1 1 1 1 1 1 1 0 10 10 10 0 0 1 0 1 0 1 0 1 0 10 10 10 0 1 1 1 1 1 1 1 1 0 10 10 10 0 0 1 0 1 0 1 0 1 0 10 10 10 0 1 1 1 1 1 1 1 1 0 10 10 10 0 0 1 0 1 0 1 0 1 0 10 10 10 0 1 1 1 1 1 1 1 1 0 10 10 10 0 0 1 0 1 0 1 0 1 0 10 10 10 0 0 0 0 0 0 0 0 0 0 10 10 10 3 1 3 7 3 3 5 7 5 2 8 4 8 6 8 
0 0 0 0 0 0 0 0 0 0 10 10 10 0 1 1 1 1 1 1 1 1 0 10 10 10 0 1 0 1 0 1 0 1 0 0 10 10 10 0 1 1 1 1 1 1 1 1 0 10 10 10 0 1 1 0 1 1 0 1 0 0 10 10 10 0 1 1 1 1 1 1 1 1 0 10 10 10 0 1 0 1 0 1 0 1 1 0 10 10 10 0 1 1 1 1 1 1 1 1 0 10 10 10 0 1 1 1 0 1 1 1 1 0 10 10 10 0 0 0 0 0 0 0 0 0 0 10 10 10 3 3 3 7 4 3 6 5 6 6 8 7 8 8 8 
